{
  "name": "Forest 1-2",
  "tileSize": 64,
  "legend": {
    "1": "grass tuft decor (no collision)",
    "2": "mushroom decor (no collision)",
    "3": "small tree decor (no collision)",
    "4": "shrubs decor (no collision)",
    "5": "flowers decor (no collision)",
    "6": "rock decor (no collision)",
    "#": "solid block 1",
    "b": "solid block 2",
    "h": "lift-h (moves left/right 3 tiles)",
    "v": "lift-v (moves up/down 3 tiles)",
    "s": "water-shallow (water tiles)",
    "w": "water-body (water tiles)",
    ".": "empty"
  },
  "spawnTiles": [
    {
      "x": 1,
      "y": 5
    },
    {
      "x": 4,
      "y": 5
    }
  ],
  "goalTile": {
    "x": 14,
    "y": 4,
    "width": 1,
    "height": 1
  },
  "tiles": [
    "###########################",
    "............bbbbbbbbb######",
    "............b........bbbb##",
    "............b............b#",
    "............b............b#",
    "............bbbb.........b#",
    "#######...#####bbbb..bb..b#",
    "######....###.....b...bb..#",
    "######....###.......b.....#",
    "#####.......#............##",
    "####........#...........###",
    "#......#....#......#...####",
    "#.....##....##....###.....#",
    "#....#####..###.....#.....#",
    "#..##########.##....##....#",
    "#....########..#....##....#",
    "#....######.....#..####..##",
    "##...######.........##..###",
    "##vvv##.##..........##.#.##",
    "##.......#........####....#",
    "##.......#......###..##b..#",
    "##.......#.#..............#",
    "##..######.##...........bb#",
    "##..bbbbb#..###...........#",
    "##..bbbbb#....#...........#",
    "###......#....##......##..b",
    "#######..#..........###...b",
    "#........#.......##......bb",
    "#........#......##......bbb",
    "#..##..###....###......bbbb",
    "#.b##....#....#.......bbbbb",
    "#..####..##..........bbbbbb",
    "#..#########........bbbbbbb",
    "#b.b.########.....#...bbbbb",
    "#..b........##...##......##",
    "#.............#..........##",
    "#.........................#",
    "#......#####.....#####....#",
    "#.....######....######....#",
    "###########################"
  ],
  "decor": [
    "...........................",
    "...........................",
    "...........................",
    "...........................",
    "...........................",
    "...6......1......1...6.....",
    "...........................",
    "...........................",
    ".........................1.",
    "...........................",
    "...................3.......",
    ".............5.............",
    ".........5.................",
    "..........1....5.....1.....",
    "...........................",
    "................2..5..1..4.",
    ".1......................1..",
    "...........................",
    "..................1........",
    "................4.....1....",
    "...........................",
    ".....1.1...................",
    ".............5.............",
    "...........................",
    "..3........................",
    "...5.1..............4......",
    ".................4.........",
    "...........................",
    ".......5......5............",
    "...........................",
    "...........................",
    "........1..................",
    "............4..............",
    ".................1.........",
    "...........................",
    "...........................",
    "........6........4..4......",
    "...........................",
    "...4.2........4........11..",
    "..........................."
  ]
}
